{
    "map": {
        "tile_set": "Tile1.png",
        "sizeX": 30,
        "sizeY": 11,
        "exits": [
            {
                "mapX": 2,
                "mapY": 1,
                "jx": 1,
                "jy": 3,
                "dir": 1,
                "tileX": 29,
                "tileY": 3
            },
            {
                "mapX": 2,
                "mapY": 1,
                "jx": 1,
                "jy": 4,
                "dir": 1,
                "tileX": 29,
                "tileY": 4
            },
            {
                "mapX": 2,
                "mapY": 1,
                "jx": 1,
                "jy": 5,
                "dir": 1,
                "tileX": 29,
                "tileY": 5
            }
        ],
        "tile_type_layer_1": [
            1,1,1,1,1,1,1,1,1,1,1,1,1,1,1,1,1,1,1,1,1,1,1,1,1,1,1,1,1,1,
			1,1,0,0,0,0,0,0,0,0,0,0,1,0,0,0,0,1,0,0,0,0,0,0,1,0,0,0,0,0,
			1,0,0,0,0,0,0,0,0,0,0,0,0,0,0,0,0,0,0,0,0,0,0,0,0,0,0,0,0,0,
			1,0,0,0,0,0,0,0,0,0,0,0,0,0,0,0,0,0,0,0,0,0,0,0,0,0,0,0,0,1,
			0,0,0,0,0,0,0,0,0,0,0,0,0,0,0,0,0,0,0,0,0,0,0,0,0,0,0,0,0,1,
			0,0,0,0,0,0,0,0,1,0,0,0,0,0,0,0,0,0,0,0,0,0,0,0,0,0,0,0,0,1,
			0,0,0,0,0,0,0,0,0,0,0,0,0,1,0,0,0,0,0,0,0,0,0,0,0,0,0,0,0,1,
			0,0,0,0,0,0,0,0,0,0,0,0,0,0,0,0,0,0,0,0,0,1,1,0,0,0,0,0,0,0,
			1,1,0,0,0,0,0,0,0,0,0,0,0,0,0,0,0,0,0,1,0,0,0,0,0,1,0,0,0,0,
			0,0,0,0,1,1,0,0,0,0,0,0,0,1,1,0,0,0,0,0,0,0,0,0,1,1,1,1,0,0,
			0,0,0,0,0,0,0,0,0,1,1,0,0,0,0,0,1,0,1,1,0,0,0,1,1,1,1,1,0,1
        ],
        "tile_layer_1": [
            23,23,23,23,23,23,23,23,23,23,23,23,23,23,23,23,23,23,23,23,23,23,23,23,23,23,23,23,23,23,
			23,23,23,23,23,23,23,23,23,23,23,23,23,23,23,23,23,23,23,23,23,23,23,23,23,23,23,23,23,23,
			23,23,23,23,23,23,23,23,23,23,23,23,23,23,23,23,23,23,23,23,23,23,23,23,23,23,23,76,23,76,
			23,23,23,23,23,23,23,23,23,23,23,23,23,23,23,23,23,23,23,23,23,23,23,23,23,76,23,23,76,76,
			23,23,23,23,23,23,23,23,23,23,23,23,23,23,23,23,23,23,23,23,23,23,23,23,76,23,76,76,76,76,
			23,23,23,23,23,23,23,23,23,23,23,23,23,23,23,23,23,23,23,23,23,23,23,23,23,76,23,76,76,76,
			23,23,23,23,23,23,23,23,23,23,23,23,23,23,23,23,23,23,23,23,23,23,23,23,23,23,23,76,76,76,
			23,23,23,23,23,23,23,23,23,23,23,23,23,23,23,23,23,23,23,23,23,23,23,23,23,76,23,23,23,76,
			23,23,23,23,23,23,23,23,23,23,23,23,23,23,23,23,23,23,23,23,23,23,23,23,23,23,23,23,23,76,
			23,23,23,23,23,23,23,23,23,23,23,23,23,23,23,23,23,23,23,23,23,23,23,23,23,23,23,23,23,23,
			23,23,23,23,23,23,23,23,23,23,23,23,23,23,23,23,23,23,23,23,23,23,23,23,23,23,23,23,23,23
        ],
        "tile_layer_2": [
            80,81,81,81,81,81,81,81,81,81,81,81,81,81,81,81,81,81,81,81,81,81,81,81,81,81,81,81,81,82,
			22,22, 5,13, 5,13,13, 0, 5,13,13,21,22, 5,13,21,21,22,13, 5,21, 0,21, 5,22, 5,21, 0, 5,13,
			22, 5, 0,13, 0,10,21,21, 0,13,21,21,13, 0,21, 0,21, 5,13, 0,21,21, 0,13,13, 0, 0, 0,21, 0,
			22,13,21,21, 0, 0,13, 0, 0,21, 5, 0, 0, 0, 0, 0,21, 0, 0, 0,21, 0, 0, 0, 0, 0, 0, 0, 0,93,
			 5,13,21, 0,14,14, 0, 8, 0, 0, 0, 0, 0, 0, 0, 0, 0, 0, 0, 0, 0, 0, 0, 0, 0, 0, 0, 0, 0,94,
			13, 0, 0, 0, 0, 0, 0, 0,12, 0, 0, 0, 0, 0, 0, 8, 0, 0, 0, 0, 0, 0, 0, 0, 0, 0, 0, 0, 0,95,
			 0, 0, 0, 0, 0, 0, 0, 0, 0, 0, 0, 0, 0, 4, 0, 0, 0, 0, 0, 0, 0, 0, 0, 0, 0, 0, 0, 0, 0,90,
			 0, 0, 0, 0, 0, 0, 0, 0, 0, 0, 0,47, 0, 0, 0, 0, 0, 0, 7, 0, 0,29,30, 0, 0, 0, 0, 0, 0, 0,
			73,74, 8, 0, 0, 0,15, 0, 0, 0, 0, 0, 0, 0, 8, 0, 0, 0, 0,12, 0, 0, 0, 0, 0,12,27, 0, 0, 0,
			 0, 0,15,72,73,74,75, 0, 7,20,20, 0, 0,29,30, 0, 0, 0, 0, 0, 0, 0, 0, 0,37,38,37,38, 0, 0,
			 0, 0, 0, 0, 0, 0, 0, 3,72,73,74,75, 0, 0, 0, 0, 4, 0, 0, 0, 0, 0, 0,12,37,38,37,38, 0,12
        ],
		"auto_tile_layer" : [
			0,0,0,0,0,0,0,0,0,0,0,0,0,0,0,0,0,0,0,0,0,0,0,0,0,0,0,0,0,0,
			0,0,0,0,0,0,0,0,0,0,0,0,0,0,0,0,0,0,0,0,0,0,0,0,0,0,0,0,0,0,
			0,0,0,0,0,0,0,0,0,0,0,0,0,0,0,0,0,0,0,0,0,0,0,0,0,0,0,0,0,0,
			0,0,0,0,0,0,0,0,0,0,0,0,0,0,0,0,0,0,0,0,0,0,0,0,0,0,0,0,0,0,
			0,0,0,0,0,0,0,0,0,0,0,0,0,0,0,0,0,0,0,0,0,0,0,0,0,0,0,0,0,0,
			0,0,0,0,0,0,0,0,0,0,0,0,0,0,0,0,0,0,0,0,0,0,0,0,0,0,0,0,0,0,
			0,0,0,0,0,0,0,0,0,0,0,0,2,2,2,2,2,2,0,0,0,0,0,0,0,0,0,0,0,0,
			0,0,0,0,0,0,0,0,0,0,0,0,2,2,2,2,0,2,0,0,0,0,0,2,2,2,2,2,2,0,
			0,0,0,0,0,0,0,0,0,0,0,0,2,2,2,2,2,2,2,2,2,2,2,2,2,0,2,2,2,0,
			0,0,0,0,0,0,0,0,0,0,0,0,2,2,2,2,2,2,2,2,2,2,2,2,0,0,0,0,2,0,
			0,0,0,0,0,0,0,0,0,0,0,0,2,2,2,2,2,2,2,2,2,2,2,0,0,0,0,0,2,0
		],		
        "tile_layer_4": [
            0, 0, 0, 0, 0, 0, 0, 0, 0, 0, 0, 0, 0, 0, 0, 0, 0, 0, 0, 0, 0, 0, 0, 0, 0, 0, 0, 0, 0, 0,
			0, 0, 0, 0, 0, 0, 0, 0, 0, 0, 0, 0, 0, 0, 0, 0, 0, 0, 0, 0, 0, 0, 0, 0, 0, 0, 0, 0, 0, 0,
			0, 0, 0, 0, 0, 0, 0, 0, 0, 0, 0, 0, 0, 0, 0, 0, 0, 0, 0, 0, 0, 0, 0, 0, 0, 0, 0, 0, 0, 0,
			0, 0, 0, 0, 0, 0, 0, 0, 0, 0, 0, 0, 0, 0, 0, 0, 0, 0, 0, 0, 0, 0, 0, 0, 0, 0, 0, 0, 0, 0,
		   41,42, 0, 0, 0, 0, 0, 0, 0, 0, 0, 0, 0, 0, 0, 0, 0, 0, 0, 0, 0, 0, 0, 0, 0, 0, 0, 0, 0, 0,
		   49,50,51, 0,41,42, 0, 0, 0, 0, 0, 0, 0, 0, 0, 0, 0, 0, 0, 0, 0, 0, 0, 0, 0, 0, 0, 0, 0, 0,
		   57,58,59,48,49,50,51, 0, 0,41,42, 0, 0, 0, 0, 0, 0, 0, 0, 0, 0, 0, 0, 0, 0, 0, 0, 0, 0, 0,
		   65,66,67,56,57,58,59, 0,48,49,50,51, 0, 0, 0, 0, 0, 0, 0, 0, 0, 0, 0, 0, 0, 0, 0, 0, 0, 0,
			0,41,42,64,65,66,67, 0,56,57,58,59, 0, 0, 0, 0, 0, 0, 0, 0, 0, 0, 0, 0, 0, 0, 0, 0, 0, 0,
		   48,49,50,51, 0, 0,41,42,64,65,66,67, 0, 0, 0, 0, 0, 0, 0, 0, 0, 0, 0, 0,31,31,31,31, 0, 0,
		   56,57,58,59, 0,48,49,50,51, 0, 0, 0, 0, 0, 0, 0, 0, 0, 0, 0, 0, 0, 0, 0,39,39,39,39, 0, 0 
        ],
        "ennemy_info": [
            {
                "type": 0,
                "mapX": 8,
                "mapY": 4
            },
            {
                "type": 0,
                "mapX": 14,
                "mapY": 4
            }
        ]
    }
}